Age Group,Alcohol Use,Drug Use,Female,Male,Total deaths both
15-20,0,7,0,7,7
20-25,3,16,0,19,19
25-30,11,27,8,30,38
30-35,46,53,14,85,99
35-40,103,89,34,158,192
40-45,153,114,213,54,267
45-50,257,92,75,274,349
50-55,564,109,121,552,673
55-60,839,79,186,732,918
60-65,848,40,170,718,888
65-70,773,26,197,602,799
70-75,469,9,123,355,478